1111111111
1E0000C001
1000000001
100P001001
1111111111