11111111111111111111111111111111111111111111
1P0000000000000000000000000000000000000000C1
111000000000111111110000C0000111111111001111
1000000000000000000000000000000000000000F001
10C00C00000000CC0000CC00C00C0000C0000C000001
100000000000000000000000C00000F0000000000001
100000C0000000000000C000C0000000C11111111111
1000000000000000F000000F00000000000000000001
111111100000000000000000C0000000C00000000001
10000000000000C00000000000000000000000000001
111111111111111100000000C000000C000000000001
100000000000000000000000C0000000000000000001
1C011111111111111111000000011111111111111111
100000000000000000F00000C0000000000000000001
100000000000000000F00000CC000000000000000001
100000000000000000F0000000000000000000000001
1C0000000000000000000000C00000000000000000E1
11111111111111111111111111111111111111111111