1111111111111111111111111111111111
100000000000000C00000E000000000001
101001010010000010100100000C010101
1110010010101010001001000000010101
10P000000C00C0000000010000000000C1
1111111111111111111111111111111111